NO ./elem/north.xpm
SO ./elem/south.xpm
WE ./elem/west.xpm
EA ./elem/east.xpm
F 224,224,224
C 119, 140, 218

111111
101001
1N0001 1
110101
111111