NO ./elem/ north.xpm
SO ./elem/south.xpm
WE ./elem/west.xpm
EA ./elem/east.xpm
C   1,21,0
F 224,224,224

111111
101001
1N0001 1
110101
111111