NO ./elem/north.xpm
SO     ./elem/south.xpm
WE           ./elem/west.xpm
EA     ./elem/east.xpm
F 255 , 22, 1
C      130 ,  240 , 25

111    
101                      
111     
    111
    101
    111
       1111
       1001
       1001
       1S01
       1111




