NO     ./elem/north.xpm
SO      ./elem/south.xpm
WE           ./elem/west.xpm
EA     ./elem/east.xpm
F 0,0,0
C 255,255,255

11111
10001
10W01
10001
11111
