NO     ./elem/north.xpm
SO       ./elem/south.xpm
WE      ./elem/west.xpm
EA     ./elem/east.xpm
F        220,  100,   0
C        225,  30 ,   0

111        1111111111111111111111111
101        1000000000110000000000001
111      111011000001110000000000001
        100100000000000000000000111
111111111011000001110000000000001
100000000011000001110111111111111
11110111111111011100000010001
11110211111111011101010010001
11000000110101011100000010001
10000000000000001100000010001
10000W000000000001101010010001
1100000111010101111101111000111
11110111 1110101 101111010001
11111111 1111111 111111111111