NO ./elem/north.xpm 
SO     ./elem/south.xpm
WE           ./elem/west.xpm
EA     ./elem/east.xpm
F 224,224,224
C      130 ,  240 , 25

1111111    
100S001
1000001
1000101
1000101
1111111