NO     ./elem/north.xpm
SO      ./elem/south.xpm
WE           ./elem/west.xpm
EA     ./elem/east.xpm
F 255 , 22 , 251
C      130 ,  240 , 255        

11111
10001
10W01
10001
11111
110S1
11111