NO ./elem/north.xpm 
SO     ./elem/south.xpm
WE           ./elem/west.xpm
EA     ./elem/east.xpm
F 224,224,224
C      119, 140, 218

1111111    
1000101
1010001
10N0001
1000101
1100001
1111111