NO     ./elem/n
SO       ./elem/s
WE      ./elem/w
EA     ./elem/e
F        220,  100,   0
C        225,  30 ,   0
1111111
1000001
10100N1
1000001
1110111
       
1111111