NO ./elem/grass.xpm
SO     ./elem/south.xpm
WE           ./elem/west.xpm
EA     ./elem/east.xpm
F 224,224,224
C      119, 140, 218

1111
1001
1N00
1101
1111