NO ./elem/north.xpm 
SO     ./elem/south.xpm
WE           ./elem/west.xpm
EA     ./elem/east.xpm
F 224,224,224
C      130 ,  240 , 25

111111    
100001
10S001
100001
111111