NO     ./elem/n
SO       ./elem/s
WE      ./elem/w
EA     ./elem/e
F        220,  100,   0
C        225,  30 ,   0
1111111
1000001 1
10100N0101
1000001101
1110111111
11111111 1
1111111111