NO ./elem/north.xpm 
SO     ./elem/south.xpm
WE           ./elem/west.xpm
EA     ./elem/east.xpm
F 224,224,224
C      30, 30, 30

1111111    
1000101
1010001
10E0001
1000101
1100001
1111111